0 0 0 0 0 0 0 0 0 0 0 0 0 0 0 0 0 0 0 0 0 0 0 0 0
0 1 1 1 1 1 1 1 1 1 1 1 1 1 1 1 1 1 8 1 1 2 2 1 0
0 1 2 2 1 1 1 1 1 1 6 6 6 1 1 1 1 1 1 1 9 3 3 1 0
0 1 2 2 1 8 8 1 1 1 1 1 1 1 1 1 1 1 1 1 3 2 9 1 0
0 1 1 1 1 8 8 1 1 1 1 1 1 1 1 1 1 1 1 1 3 2 9 1 0
0 1 1 1 1 1 1 1 1 1 1 1 1 1 1 1 1 1 1 1 1 1 1 1 0
0 1 1 1 1 5 1 1 1 1 1 1 1 1 1 1 1 1 1 1 1 1 1 1 0
0 1 1 1 1 9 1 1 1 1 1 1 1 1 1 7 7 1 1 1 1 1 7 1 0
0 1 1 1 1 9 1 1 1 1 1 1 1 1 1 1 7 1 1 1 1 1 7 1 0
0 6 1 1 1 1 1 1 1 1 1 1 1 1 1 1 1 1 1 1 1 1 1 1 0
0 1 1 1 1 1 1 1 1 1 1 1 1 1 1 1 1 1 1 1 1 1 1 1 0
0 4 1 4 4 4 1 1 1 1 1 1 1 1 1 1 1 1 1 1 1 1 1 1 0
0 1 1 4 4 4 1 1 1 1 1 1 1 1 1 1 1 1 1 5 1 1 1 1 0
0 1 1 1 1 1 1 1 1 1 1 1 1 1 1 1 1 1 1 1 1 1 1 1 0
0 1 1 1 1 1 1 1 1 1 1 1 1 1 1 1 1 8 8 1 1 2 1 1 0
0 1 1 3 1 1 6 6 6 1 1 1 3 4 1 2 1 1 1 1 1 1 1 1 0
0 1 1 3 1 1 1 6 1 1 1 1 4 3 2 1 1 1 1 1 1 8 8 1 0
0 1 5 1 1 1 1 1 1 1 1 1 1 1 1 1 1 1 1 1 1 8 8 1 0
0 1 1 1 1 1 1 1 1 1 8 1 1 1 1 1 1 1 1 1 1 1 1 1 0
0 0 0 0 0 0 0 0 0 0 0 0 0 0 0 0 0 0 0 0 0 0 0 0 0